. . . . . . . . .
. . . . . . . . .
. . . . . . . . .
. . . . . . . . .
. .         . . .
. .   . .   . . .
. .   . . .   . .
. .   . . .   . .
. .   . . .   . .
. .   . .   . . .
. .         . . .
. . . . . . . . .
. . . . . . . . .
. . . . . . . . .
. . . . . . . . .
